1111111111111111111111111111111111
1EP0000000000000000000000000001111
1000000111000000111011000000000011
10000011C0000001111111110001111001
11000001110000000111101111001111C1
1100011111100000011111111110011111
1100001111110000000111111000000001
1000000011111000000001110000000011
1000000000000000000000000000000011
1110000000000000000000000000000111
1111100000111111111111111111100001
1111100011111000000000000000000001
1100001111000000111111111110000001
1000000000000000001100000000000001
1100000111000000011C01110000000011
11000000C1000000011111100000000111
11100011111110000001110000000C1111
1111111111111111111111111111111111