111111111111
1P00C00E00C1
111111111111