1111111111111111111111111111111
10010000C0000000001100000011111
10P0011111000111101110000000111
1010110010011111000011100000111
10001100111100010011100000C0011
1011110000000000011111100000011
1000111100010000E00000000000111
1C00001000010001110111110000001
10010000C0000000000000000000001
100001111100011110000C000111111
1010110010011111110000000110011
1000110011110001000111000000011
1011110000000000001111110000011
1000111100010010111111100000001
1C00001000010001111011111111C01
1111100000011110111011111100011
11000000C1110000011111110001111
1000000000000000001100000011111
11111111000001111C1100001110111
1111111111111111111111111111111